the|die|der|die
of|von|von|der|auf
and|und|und|sowie
to|zu|an|auf|auf
in|in|unter|auf|unter
that|dass|das|die|der
he|er|Der|er
was|war|wurde|war|wurde
it|es|it|es
his|seine|sein
with|mit|bei|unter
is|ist|ist|lautet|lautet
for|fï¿½r|unter|fï¿½r
as|als|wie|unter|als
you|Sie|du|Sie
had|hatte|hatten|hat|hatte
not|nicht|nicht|und nicht
on|auf|unter|auf
be|sein|werden|sei
at|unter|auf|bei|unter
but|sondern|aber|sondern
by|von|durch|unter|von
her|ihre|ihr
this|diese|dieses|dieser
which|die|das|der|welche
or|oder|oder|bzw
have|haben|besitzen|haben
from|von|aus|unter|auf
she|sie|sie
de|de|de|unter
they|sie|Die|sie
all|alle|alles|alle
him|er|ihn|ihm
were|waren|wurden|wurde|waren
are|sind|sind|werden
my|meine|mein
we|wir|wir
so|also|so|also
me|ich|mich|Ich
one|eine|ein|eine
no|keine|nein
their|ihre|deren|ihr
an|eine|ein|an|an
if|wenn|falls|wenn
there|dort|hier|dort
said|sagte|so|sagt|sagte
who|die|der|wer
when|wenn|bei|als
them|sie|Die|Sie
would|wï¿½rde|wï¿½rden|wï¿½re|wï¿½rde
been|wurde|war|gewesen
will|wird|werden
what|was|welche|was
do|tun|machen
la|la|Die
out|aus|heraus|raus|aus
up|auf|nach oben|oben|auf
any|jede|alle|eine
more|mehr|weitere
then|dann|dann|und dann
your|Ihr|Ihre
into|in|unter|in|auf
some|einige|etwas|einige
now|jetzt|nun|jetzt
man|man|Mann|Mann
has|hat|hat|verfï¿½gt ï¿½ber
could|kï¿½nnte|konnte|kann|kï¿½nnten
other|andere|Sonstiges|Sonstige
our|unser|unsere
about|ï¿½ber|ï¿½ber|zu
very|sehr|sehr
time|Zeit|Uhrzeit|Die Zeit|Zeitpunkt
than|als|als|als bei
et|und|und|sowie|et
its|seine|sein|ihre
may|Mai|may|Mai
project|Projekt|Das Projekt
upon|auf|unter|auf|bei
only|nur|nur|ausschlieï¿½lich
le|le|Die|Der
en|en|de|en
like|wie|wie|wie zum Beispiel
little|wenig|kleine|klein|Die kleine
can|kann|kï¿½nnen|kann
see|siehe|siehe
work|Arbeit|arbeiten|Werk
these|diese|Die|dieser
did|hat|tat|hat
such|wie|solche|Diese
two|zwei|zwei
que|que|que|
before|vor|vor|bevor
well|gut|gut
great|groï¿½artig|toll|groï¿½e
made|gemacht|erstellt|hergestellt
should|sollte|soll|sollten
after|nach|nach|unter
must|muss|mï¿½ssen|muss
us|us|usa|Wir
over|ï¿½ber|ï¿½ber|unter
good|gut|gute|gutes
know|wissen|kennen
men|Mï¿½nner|Herren|men
first|erste|erstes|erster
how|wie|wie
much|viel|viele|vieles
down|unten|nach unten|runter|abwï¿½rts
day|Tag|Tag|Der Tag
where|wobei|wo|wobei
come|kommen|komm|Kommen Sie
mr|Herr|mr|Herr
old|alt|alte|altes
never|niemals|nie|nicht
most|Die meisten|am meisten
les|les|les
way|Weg|Weise|Art und Weise|Art
those|die|diese
here|hier|hier|unter
life|Leben|das Leben
long|lang|lange
go|gehen.|go
own|eigene|eigenes|eigenen
came|kam|gekommen|kamen|kam
tm|tm|tm
without|ohne|ohne
shall|soll|wird|sollen|soll
even|sogar|auch|selbst
through|ï¿½ber|durch|ï¿½ber
himself|selbst|sich|sich selbst|er selbst
make|machen.|erstellen
many|viele|zahlreiche|vielen
il|il|il|II
being|unter|sein|die
say|sagen|sagen|Sagen Sie
again|wieder|erneut|nochmals|Wiederum
back|zurï¿½ck|Rï¿½ckseite|Rï¿½cken
too|zu|auch
might|kï¿½nnte|kann|vielleicht|kï¿½nnte
under|unter|unter|unter
every|jede|alle|jeder
new|neu|neue
am|am|unter|bei
while|wï¿½hrend|und|wï¿½hrend
people|Menschen|Leute|Personen|Die Menschen
away|weg|auswï¿½rts|weg
think|denken|denke|denken Sie|denken Sie an
just|nur|einfach|nur
un|un|un|unter|de
place|Ort|Platz|Ort
still|immer noch|noch|noch immer
last|zuletzt|letzte
take|Nehmen Sie|siehe|Nehmen Sie
same|dieselbe|dasselbe|gleich|dieselben
went|ging|gegangen|geht|ging
found|gefunden|gefunden
yet|dennoch|aber|jedoch|und doch
house|Haus|Das Haus|Haus
hand|Hand|Handbuch|Hand
thought|dachte|Gedanken|Gedanke|gedacht
se|se|siehe|se|s
des|des|von|der
right|rechts|rechts|richtig
eyes|Augen|Augen|Die Augen
though|obwohl|allerdings
works|Werke|Arbeiten|Werk|arbeitet
years|Jahre|Jahren|Jahr|Jahre
give|geben.
also|auch|auï¿½erdem|auch
off|aus|ab|von
three|drei|3|drei
son|Sohn|Der Sohn|son
nothing|nichts|nichts|nix
part|Teil|Teil|zum Teil
another|eine andere|eine weitere|ein weiteres|ein anderes
once|einmal|sobald|einmal
die|die|die
night|Nacht|nachts|Die Nacht
get|bekommen.|erhalten|abrufen|holen
young|junge|jung|junges
against|gegen|gegen|gegenï¿½ber
things|Dinge|Sachen|Die Dinge|Dinge
ever|immer|stets|jemals
let|lassen Sie|lassen|Lassen Sie
face|Gesicht|Seite|Gesicht|Gesicht
qui|qui|qui
head|Kopf|Leiter|Kopf|Leitung
god|Gott|Gott
left|links|Link
world|Welt|Die Welt|weltweit
full|vollstï¿½ndig|voll|komplett
love|Liebe|Liebe|lieben
each|jede|jedes|jeder
saw|siehe|sah|sï¿½ge
put|setzen.|stellen
tell|sagen|sagen Sie|informieren Sie
because|denn|weil
few|wenige|einige|einige wenige
sir|Herr|Sir|Herr|Mein Herr
far|weit|weiter|fern|weit
took|nahm|nahmen|hat|nahm
use|verwenden.|benutzen
why|warum|weshalb|Warum ?
always|immer|stets|immer
set|einstellen.|festlegen|setzen
du|du|Sie|du
both|beide|sowohl|beides
between|zwischen|zwischen|unter
ne|ne|ne
mrs|Frau|Frau
look|siehe|siehe
father|Vater|Der Vater|Vater
mind|Geist|Verstand|Geist
country|Land|Land|Das Land
heart|Herz|Herzen|Das Herz
room|Zimmer|Raum|Zimmer|Das Zimmer
home|Startseite|Zuhause|home
days|Tage|Tagen|Tage
thing|Sache|Ding|Die Sache|Sache
king|Kï¿½nig|Der Kï¿½nig|Kï¿½nig
going|unter|auf
looked|siehe|siehe
states|Staaten|Zustï¿½nde|Lï¿½nder|stellt fest
got|hat|haben|erhalten
side|Seite|Die Seite|Seite|Website
general|allgemein|Allgemeines
water|Wasser|Wasser|Wasser
seemed|schien|erschien|scheint|schien
half|halb|Hï¿½lfte|halbes
having|mit|unter|mit
called|genannt.|namens|mit der Bezeichnung|unter der Adresse
whom|die|den|der
lord|Fï¿½rst|Herr|Lord|Fï¿½rst
name|Name|Name|Der Name
done|fertig|erledigt
find|finden.|finden Sie
door|Tï¿½r|Tï¿½r|Tï¿½r
moment|Moment|Zeitpunkt|Augenblick
told|sagte|erklï¿½rte|sagte|erklï¿½rte
whole|ganz|ganze|gesamte|Ganzes
asked|fragte|gefragt|fragt|fragte
better|besser|bessere|besseres
heard|gehï¿½rt|hï¿½rte|gehï¿½rte
however|jedoch|aber|allerdings
ja|ja|ja
electronic|elektronisch|elektronische|elektronisch
something|etwas|etwas|irgendetwas
state|Staat|Zustand|Stand|staatlich
seen|gesehen|siehe|gesehen
among|unter|bei|auf|unter
course|Kurs|Der Kurs|Lehrgang|Lehrveranstaltung
end|Ende|end|beenden
knew|wusste|kannte|wussten
soon|bald|demnï¿½chst
van|van|van|
almost|fast|beinahe|nahezu
terms|Bedingungen|Begriffe|Bestimmungen|Konditionen
small|klein|klein
pas|pas|pas|pass
oh|oh|ach
enough|genug|genï¿½gend|ausreichend
pour|fï¿½r|pour
ce|ce|ce
mother|Mutter|Mutter|Die Mutter
hands|Hï¿½nde|Hï¿½nde|Die Hï¿½nde|Hï¿½nden
nor|noch|und|noch|auch nicht
thus|also|daher|deshalb
woman|Frau|Die Frau|Frau
foundation|Stiftung|Grï¿½ndung|Die Stiftung
light|Licht|leicht|Beleuchtung|hell
yes|ja|ja
war|Krieg|war|Krieg
does|tut|macht|tut|tut
quite|ziemlich|recht|ganz|ziemlich
cannot|kann nicht|kann nicht|kï¿½nnen nicht|nicht
since|seit|seit|da
der|der|Die|der
words|Wï¿½rter|Worte|Wortlaut|Worte
public|ï¿½ffentlich|ï¿½ffentlichkeit|ï¿½ffentliche|ï¿½ffentliches
est|est|est|st
want|wollen|mï¿½chte|mï¿½chten
until|bis|bis|bis zu
gave|gab|hat|gab
white|weiï¿½|weiss
best|am besten|beste
word|Wort|Das Wort|Wort
den|den|die
given|gegeben|unter|angegeben
brought|brachte|gebracht|bringt
next|nï¿½chste|nï¿½chstes|weiter
others|andere|Sonstige|Sonstiges
poor|arm|armes|arm|armes
death|Tod|Der Tod
thou|du|Sie
het|het|he|ht|het
morning|Morgen|Morgens
taken|genommen|aufgenommen|entnommen
whose|deren|dessen|deren
power|Macht|Strom|Leistung|Macht
turned|gedreht.|wurde
perhaps|vielleicht|eventuell|mï¿½glicherweise
within|innerhalb|unter|innerhalb von|in
money|Geld|Geld
met|traf|trafen|met
till|bis|bis|bis zu
lady|Dame|Frau
miss|Miss|vermissen|vermissen|vermisse
point|Punkt|Adresse|Adresse
used|gebraucht|verwendet|gebrauchte
began|begann|begonnen|beginnt|begann
large|groï¿½|groï¿½e|Groï¿½es
voice|Stimme|Sprache|Stimme|Stimme
anything|alles|alles was|irgendetwas
rather|eher|sondern|vielmehr|ziemlich
felt|Filz|Filz|filzen
high|hoch|hohe|hoch
kind|freundlich|freundliche|nett|liebe
present|Gegenwart|prï¿½sentieren|Geschenk
keep|behalten.|halten|beibehalten|Behalten Sie
themselves|selbst|sich|sich selbst|sie selbst
certain|bestimmte|gewisse|einige|bestimmtes
united|vereinigt|Vereint
year|Jahr|Jahr
form|Formular|Formblatt|Formular|form
less|weniger|weniger
four|vier|vier|4
matter|Materie|Sache|Angelegenheit|Materie
myself|mich|ich selbst|selbst|mich selbst
stood|stand|steht|stand
true|wahr|echt|richtig|echtes
land|Land|Land|Grundstï¿½ck|Grundstï¿½cke
indeed|in der Tat|tatsï¿½chlich
si|si|si
together|zusammen|gemeinsam
round|rund|Runde
means|bedeutet|bedeutet|bedeutet|heiï¿½t
sent|gesendet|geschickt|gesandt
agreement|Vereinbarung|Abkommen|Einigung|Zustimmung
dear|liebe|Lieber
order|Bestellung|bestellen
during|wï¿½hrend|bei|unter
often|oft|hï¿½ufig|Oftmals
near|in der Nï¿½he von|bei|in der Nï¿½he
friend|Freund|Freundin|Freunde|Freundschaft
feet|Fï¿½ï¿½e|Fï¿½sse|Fï¿½ï¿½en|Fuï¿½
nature|Natur|Die Natur
read|lesen|Lesen Sie
children|Kinder|Kinder|Kindern
plus|plus|sowie|und|sowie
second|zweite|zweites|zweiten
help|Hilfe|helfen|Unterstï¿½tzung
fire|Feuer|Brand
five|fï¿½nf|fï¿½nf|5
above|ï¿½ber|ï¿½ber|oben
received|erhalten|empfangen|erhalten|eingegangen
law|Gesetz|Recht|Gesetz|Recht
believe|glauben|glaube|glauben Sie
sea|Meer|See|Meer
known|bekannt|bekannt unter|bekannte
hope|Hoffnung|hoffen|hoffe|hoffentlich
air|Luft|Luft|
thy|dein|Deine
girl|Mï¿½dchen|Girl|Frau|Mï¿½dchen
herself|selbst|sich|sich selbst|sie selbst
te|te|te|Die
case|Fall|Fall|Fall|Kasten
free|kostenlos|frei|gratis
city|Stadt|Die Stadt
passed|bestanden|ï¿½bergeben|weitergegeben
along|entlang|unter|auf
alone|allein|alleine
says|sagt|sagt|so
lui|lui|lui
par|par|unter|ï¿½ber|par
forth|weiter|heraus|hervor|aus
hundred|hundert|100|hunderte
wife|Frau|Ehefrau|Die Frau|Frau
elle|elle|elle
sure|sicher|natï¿½rlich|klar
fact|Tatsache|Fakt|Fakten|Tatsache
number|Nummer|Zahl|Nummer|Nummer
sa|sa|sa
looking|siehe|Blick
person|Person|Mensch|Die Person|Person
hear|hï¿½ren|hï¿½ren Sie
open|ï¿½ffnen|ï¿½ffnen Sie|offen
therefore|daher|deshalb
gone|gegangen|weg|verschwunden
already|bereits|schon|bereits
boy|Junge|Jungen|Junge
english|Englisch|Englisch
een|een|een|ede|ee
several|mehrere|verschiedene|einige
times|mal|mal|Zeiten
return|return|zurï¿½ck|Rï¿½ckgabe
license|Lizenz|Lizenz|Die Lizenz
sur|sur|unter|auf
letter|Schreiben|Brief|Schreiben Sie|Buchstabe
john|john|johannes|john
business|Unternehmen|Geschï¿½ft|Business|Geschï¿½ftlich
whether|ob|ob die|ob
body|Kï¿½rper|Einrichtung|Stelle|Kï¿½rper
child|Kind|das Kind|Kind
either|entweder|entweder
held|gehalten|gehalten von|statt|halten
church|Kirche|Die Kirche|Kirche
el|el|el
least|am wenigsten|zumindest|wenigsten
leave|verlassen.|verlassen Sie
literary|Literatur|literarisch|literarische
copyright|Copyright|Urheberrecht
rest|Rest|Rest|Pause
cried|rief|weinte|schrie|riefen
women|Frauen|Frauen|Frau
friends|Freunde|Freunden|Freunde
donations|Spenden|Schenkungen|Zuwendungen
black|schwarz|schwarze
government|Regierung|Die Regierung|Staat|Regierung
lay|legen
nous|Wir|nous
itself|selbst|sich|selber|selbst
hour|Stunde|Std|Stunden|Stunde
party|Partei|Party|Partei
behind|hinter|hinter|nach
answered|antwortete|beantwortet|antwortet|beantwortete
captain|Kapitï¿½n|Hauptmann|Captain|Kapitï¿½n
replied|antwortete|antwortet|erwiderte|antwortete
chapter|Kapitel|Kapitel|Kapitel
speak|sprechen|sprechen Sie|Sprich
question|Frage|Anfrage|Die Frage|Frage
call|aufrufen|anrufen
following|unter|nach|folgende|unter
dead|tot|Tote
book|Buch|buchen|Buchen Sie
thee|Die|der|Die
lost|verloren|verschollen|verschwunden|verloren
ground|Boden|Grund|Erde|Masse
copy|kopieren.|Kopie
short|kurz|kurze|kurzes
reason|Grund|Begrï¿½ndung|Grund|Anlass
making|Herstellung von|Herstellung|Erstellung von
coming|kommend|Kommende
wish|Wunsch|wï¿½nschen|wï¿½nsche
town|Stadt|Die Stadt|Ort|Stadt
river|Fluss|Fluss|Fluss
cause|verursachen|Ursache|Ursache
england|england|englisch|Deutschland
possible|mï¿½glich|mï¿½gliche|Mï¿½glicherweise|eventuell
became|wurde|wurde|geworden
around|um|rund um|rund
laws|Gesetze|Rechtsvorschriften|Gesetze|Gesetzgebung
hard|hart|schwer|fest
sat|satt|sat|sitz|satz
really|wirklich|tatsï¿½chlich|echt
family|Familie|Die Familie
earth|Erde|Die Erde|Erde
become|werden.|werden
different|verschiedene|andere|anders|unterschiedliche
care|Pflege|Betreuung|Versorgung|Pflege
di|di|di|von
ten|zehn|10|zehn
mean|mittlere|Mittelwert|Durchschnitt|Durchschnittlich
manner|Art und Weise|Weise|Art|Verhalten
truth|Wahrheit|Die Wahrheit
twenty|zwanzig|20
strong|stark|Starke|starkes
spirit|Geist|Spiritus|Seele|Alkohol
non|nicht|nicht|non
org|org|org|organ
feel|fï¿½hlen|fï¿½hlen Sie sich|sich fï¿½hlen|fï¿½hlen Sie
thousand|Tausend|1000|Tausend
french|franzï¿½sisch|franzï¿½sisch
er|er|er
archive|Archiv|archivieren|Archiv|Archivierung
close|schlieï¿½en
information|Informationen|Informationen|Information|Informationen
kept|gehalten|behalten|beibehalten
soul|Seele|Seele
subject|Thema|Betreff|Betreff|Gegenstand
table|Tabelle|Tisch|Tabelle
human|menschlich|Menschen|Mensch|Menschliche
rose|Rose|rosa
story|Geschichte|Die Geschichte|Artikel|Geschichte
six|sechs|sechs|6
fell|fallen|fiel|fielen
able|fï¿½hig|fï¿½hige|geeignet|fï¿½higen
need|brauchen|benï¿½tigen|Bedarf
towards|gegenï¿½ber|zu|in Richtung|zu
line|Zeile|Linie|Leitung|Zeile
red|rot|red
arms|Arme|Waffen|Armen|Die Waffen
except|auï¿½er|ausgenommen|mit Ausnahme von|auï¿½er
sometimes|manchmal|gelegentlich|manchmal auch
dark|dunkel|Dunkelheit|dunkle|schwarz
dat|dat|dat|Das
hold|halten|Halten Sie|hold
live|live|leben|live
evening|Abend|Abends
age|Alter|Alter|Alter|Alter
paid|bezahlt|bezahlte
force|Kraft|zwingen|force|erzwingen
returned|zurï¿½ckgegeben|zurï¿½ck|zurï¿½ckgeschickt|zurï¿½ckgesandt
master|Meister|Master|Herr
ready|bereit|fertig|verfï¿½gbar|bereit
beautiful|schï¿½n|wunderschï¿½n|schï¿½ne|wunderschï¿½nes
understand|verstehen.|zu verstehen
answer|Antwort|Antwort|antworten|antwortet
later|spï¿½ter|spï¿½ter|weiter
turn|drehen.|wenden
followed|gefolgt von|gefolgt von|folgte
fear|Angst|Furcht|fï¿½rchten
fine|fein|feines|fein|fein
brother|Bruder|brother|Bruder
bring|bringen|mitbringen|bringt
nearly|fast|nahezu|fast
charge|Gebï¿½hr|laden|aufladen|berechnen
early|frï¿½h|Anfang|frï¿½he|frï¿½h
dit|dit|dit|
bed|Bett|Das Bett|Bett
service|Dienstleistung|Service|Dienst
seems|scheint|erscheint|scheinbar|scheint zu sein
show|anzeigen|zeigen
doubt|Zweifel|zweifeln|Zweifel an
suddenly|plï¿½tzlich|plï¿½tzlich
north|Norden|Nord|nï¿½rdlich
written|geschrieben|schriftlich
st|st|st
comme|comme|comme|wie|siehe
sight|Ansicht|siehe|Sichtbarkeit
ask|fragen Sie|fragen
character|Zeichen|Charakter|Schriftzeichen|Buchstabe
across|ï¿½ber|ï¿½ber|unter
art|Kunst|art|Kunst
tout|tout|auf|tout
sort|sortieren
purpose|Zweck|Ziel|Zweck|Verwendungszweck
sense|Sinn|spï¿½ren|fï¿½hlen|Gefï¿½hl
south|Sï¿½den|Sï¿½d|sï¿½dlich
further|weiter|weitere
bien|bien|bien
everything|alles|alles|alles was
history|Geschichte|Die Geschichte|Geschichte
common|gemeinsame|gemeinsam|Gemeinsames
ye|ihr|Sie
including|einschlieï¿½lich|einschlieï¿½lich|darunter|inklusive
office|Bï¿½ro|Bï¿½ro|Das Bï¿½ro|Amt
interest|Interesse|Zinsen|Zins|Interesse
sun|Sonne|Die Sonne|Sonne
idea|Idee|idea|Die Idee
france|frankreich|franzï¿½sisch|Frankreich
court|Gericht|Hof|Gerichtshof
paragraph|Absatz|Paragraph|Abschnitt|Ziffer
deep|tief|deep|tiefgreifend
none|keine|kein|keins
talk|sprechen|reden|Gesprï¿½ch|sprechen Sie
chief|Chef|Leiter|Hï¿½uptling|Leiterin
account|Konto|Rechnung|Konto|Account
past|Vergangenheit|vorbei|zurï¿½ck|Vergangenheit
army|Armee|Heer
agree|zustimmen|einverstanden|stimmen|stimmen zu
carried|getragen|ï¿½bertragen|befï¿½rdert|getragen von
necessary|erforderlich|notwendig|nï¿½tig|notwendige
trademark|Marke|Markenzeichen|Warenzeichen|Handelsmarke
company|Unternehmen|Firma|Gesellschaft|Unternehmen
miles|Meilen|miles|Kilometer
else|sonst|ansonsten|else
note|Hinweis|Anmerkung|Notiz|Anmerkung
act|handeln|handeln Sie|handeln
road|Straï¿½e|Strasse|Die Straï¿½e|Straï¿½e
although|obwohl|auch wenn|obwohl
suppose|angenommen,|Nehmen wir an|Nehmen wir an dass
change|ï¿½ndern|wechseln
continued|Fortsetzung|Fortsetzung|Fortsetzung unter|Fortsetzung
taking|unter|unter|Die Einnahme von
below|unter|unten|unter
big|groï¿½|groï¿½e|Groï¿½es
reached|erreicht|erreichte|erreicht
cut|schneiden|Schnitt
eye|Auge|Auge|Blick|Augen
blood|Blut|Blut
position|Position|Standort|Stelle|Standpunkt
stand|Stand|Stand|Messestand
per|per|unter|pro|ï¿½ber
longer|lï¿½nger|mehr|lï¿½ngere
appeared|erschienen|erschien
horse|Pferd|Pferd|Pferde
che|che|che
strange|seltsam|seltsame|seltsames|seltsamen
west|West|Westen|westlich
meet|treffen|treffen Sie|kennenlernen
please|bitte|Bitte
ought|sollte|soll|sollte
neither|weder|auch nicht|keine
spoke|Speiche|Speichen|Die Speiche|sprach
cold|kalt|Kï¿½lte|kalt|kaltes
happy|glï¿½cklich|frï¿½hlich|zufrieden
future|Zukunft|kï¿½nftig|zukï¿½nftig|zukï¿½nftige
beyond|jenseits von|jenseits|ï¿½ber hinaus
street|Straï¿½e|Strasse|Straï¿½e|Die Straï¿½e
fellow|Mitstreiter|Kollege|Kollegen|Kollegin
school|Schule|Die Schule
access|Zugang|Zugang zu|Zugriff auf|Zugriff
dr|Dr.
hours|Stunden|ï¿½ffnungszeiten|Zeiten
prince|Fï¿½rst|prince|Fï¿½rst
peace|Frieden|Ruhe|Friede
low|niedrig|niedrige|gering
unless|es sei denn,|sofern nicht
feeling|Gefï¿½hl|fï¿½hlen|Gefï¿½hl
natural|natï¿½rlich|natï¿½rlich|selbstverstï¿½ndlich
run|laufen.|ausfï¿½hren|laufen lassen
front|Vorderseite|Front|vorne|Frontseite
clear|klar|lï¿½schen
forward|weiter|vorwï¿½rts|nach vorne
real|real|echt|wirklich|echte
self|selbst|selbst|sich selbst
sound|Klang|Klangbild|Klangbeispiel|Klangfarben
toward|zu|gegenï¿½ber|in Richtung|unter
refund|Erstattung|Rï¿½ckerstattung|Rï¿½ckzahlung|Erstattung
remember|erinnern Sie sich an|erinnern|erinnere dich an
certainly|sicherlich|natï¿½rlich|sicher
fair|Messe|fair|Messe|fairen
bad|schlecht|schlechtes|Schlechte
seem|scheinen|erscheinen|scheint|scheinen
added|hinzugefï¿½gt.|hinzugekommen
late|spï¿½t|Ende|spï¿½te|spï¿½tes
view|siehe|ansehen
gold|Gold|Gold
saying|unter|mit|unter
ii|ii|ii|i
pretty|hï¿½bsch|ziemlich|schï¿½n|hï¿½bsche
al|al|al
living|leben|Wohnen
comes|kommt|kommt
american|amerikanisch|amerikanisches|Amerikanische
london|london|London|Londoner
mine|meine|Bergwerk|mein
pay|bezahlen.|zahlen
knowledge|Wissen|Kenntnisse|Wissen
wind|Wind|Wind|Der Wind
trees|Bï¿½ume|Bï¿½ume|Bï¿½umen|Bï¿½ume
fall|Herbst|fallen|fall
doing|bei|tun|unter
ah|ah|ach|ah
daughter|Tochter|Die Tochter
section|Abschnitt|Rubrik|Bereich|Abschnitt
ship|Schiff|Das Schiff|Schiff
outside|auï¿½erhalb|drauï¿½en|auï¿½erhalb von
effect|Wirkung|Effekt|Wirkung|Auswirkung
boys|Jungen|Jungs|Knaben|Jungen
paper|Papier|Dokument|Papier
es|es|es
entered|eingegeben|eingetragen in|eingetragen unter|Eingetragen bei
hair|Haare|Haar|Haare
op|op|
pass|Pass|passieren
probably|wahrscheinlich|vermutlich
makes|macht|erstellt|macht|stellt
led|gefï¿½hrt|led|fï¿½hrte|gefï¿½hrt
play|spielen|Spielen Sie
mon|mon|unter|ab|mon
plain|einfach|schlicht|glatt
als|als|auch|als
ma|ma|ma
important|wichtig|wichtige|Wichtiges
footnote|Fuï¿½note|Fuï¿½note|Fussnote|Fuï¿½note
opened|geï¿½ffnet|erï¿½ffnet|geï¿½ffnet|erï¿½ffnete
send|senden.|schicken
wild|wild|wilde|wildlebend|wildes
laid|gelegt|verlegt|legte
associated|zugehï¿½rig|zugehï¿½rige|dazugehï¿½rig
wanted|gesucht|Gesucht
blue|blau|blaue|blau
permission|Genehmigung|Erlaubnis|Zulassung|Die Erlaubnis
heaven|Himmel|Himmel
husband|Ehemann|Mann|Ehemann
especially|insbesondere|vor allem|besonders
silence|Schweigen|Stille|Ruhe
domain|Domain|Domï¿½ne|Die Domain|Domain
del|del|de|del|di
green|grï¿½n|grï¿½nes
foot|Fuï¿½|Fuss|Fuï¿½
died|gestorben|verstorben|gest
attention|Achtung|Aufmerksamkeit|Hinweis
da|da|da
glad|froh|glï¿½cklich|frï¿½hlich|erfreut
arm|Arm|Der Arm
distance|Entfernung|Abstand|Distanz|Strecke
window|Fenster|Fenster|Fenster
visit|besuchen Sie|siehe|Besuchen Sie
length|Lï¿½nge|Lï¿½nge|Lï¿½nge|Dauer
paris|paris|paris
tree|Baum|Der Baum|Baum
tried|versucht|ausprobiert|probiert
con|con|kon|Betrug
minutes|Minuten|Protokoll|Protokolle|Minute
provide|anbieten.|zur Verfï¿½gung stellen|bereitstellen|bieten
bear|Bï¿½r|tragen
ago|vor|her|vor
pleasure|Vergnï¿½gen|Freude|Genuss
various|verschiedene|diverse|Verschiedenes
das|das|Das
island|Insel|Die Insel|Insel
particular|besondere|besonders|bestimmte
receive|erhalten|empfangen
ik|ik|ik
boat|Boot|Schiff|Boot
duty|Zoll|Zollsatz|Zollamt|Zoll
placed|platziert|gestellt|aufgestellt
lived|gelebt|lebte|lebten
fee|Gebï¿½hr|Honorar|Gebï¿½hren|Gebï¿½hr
support|Unterstï¿½tzung|unterstï¿½tzen
ran|lief|lï¿½uft|liefen|lief
trouble|Probleme|Schwierigkeiten|Problem|Probleme
follow|folgen|folgen Sie
society|Gesellschaft|Die Gesellschaft|Verein
according|gemï¿½ï¿½|laut|nach|entsprechend
grand|groï¿½artig|grand|groï¿½artige
strength|Stï¿½rke|Kraft|Festigkeit
desire|Wunsch|wï¿½nschen|Begehren|Wunsch
notice|Hinweis|Mitteilung|Anzeige|Hinweis
letters|Buchstaben|Briefe|Schreiben|Schreiben Sie
save|speichern|sparen
beginning|Anfang|Beginn|beginnend|Beginn
easy|einfach|leicht|einfach
sie|sie|Sie
chance|Chance|Zufall|Mï¿½glichkeit
books|Bï¿½cher|Bï¿½cher|Die Bï¿½cher
faith|Glaube|Glauben|Vertrauen|Der Glaube
sweet|sï¿½ï¿½|sï¿½ï¿½e|Sï¿½ï¿½es
instead|stattdessen|anstatt|sondern
beauty|Schï¿½nheit|Die Schï¿½nheit|Schï¿½nheit
opinion|Stellungnahme|Meinung|Ansicht|Gutachten
greater|mehr|grï¿½ï¿½er|grï¿½ï¿½ere|grï¿½ï¿½eres
try|Versuchen Sie|Versuchen Sie es mit|Versuchen Sie
writing|Schreiben|Schreiben Sie
madame|Madame|Madam|Madame
doctor|Doktor|Arzt
gentleman|Gentleman|Herr|Gentleman|Herren
battle|Schlacht|Kampf|kï¿½mpfen
latter|letztere|letzteres
whatever|was auch immer|was immer|wie auch immer
sleep|schlafen|Schlaf
heavy|schwer|schwere|schweres
third|dritte|dritter|dritte
main|Haupt|Hauptartikel|Hauptsï¿½chlich|Hauptseite
action|Aktion|Maï¿½nahme|Aktion
copies|Kopien|Exemplare|kopiert|Kopien
york|york|Yorker|York
ill|krank|schlecht|kranke|kranken
enemy|Feind|Gegner|Feindliche|Feind
individual|individuell|individuelles|individuell|individuelles
standing|stehend|Stehen|stehendes
remained|blieb|geblieben|bleibt|blieb
bound|gebunden|gebundene
carry|tragen|fï¿½hren
george|george|georg|george
yourself|selbst|Sie selbst|sich selbst|Sie
lips|Lippen|Die Lippen|Lippen
immediately|sofort|unverzï¿½glich|ab sofort
queen|Kï¿½nigin|Kï¿½nigin|Kï¿½nigin|Dame
persons|Personen|Menschen|Personen|Leute
happened|geschehen|passiert|geschah
born|geboren|geboren am|geb
hardly|kaum|kaum
object|Objekt|Gegenstand|Das Objekt|Objekt
field|Feld|Bereich|Feld|Feld
start|Start|starten
sans|ohne|ohne
smile|Lï¿½cheln|Lï¿½cheln|lï¿½chelnd
produced|hergestellt|produziert|erstellt
sister|Schwester|Die Schwester|Schwester
thinking|Denken|Denken
exclaimed|rief  aus.|rief|rief
broken|gebrochen|kaputt|zerbrochen|gebrochene
na|na|na
figure|Abbildung|siehe|Bild|Abbildung
slowly|langsam|langsam
impossible|unmï¿½glich|Unmï¿½gliche
illustration|Abbildung|Illustration|Abb|Abbildung
wide|breit|weit|breit|breit gefï¿½chert
provided|bereitgestellt|zur Verfï¿½gung gestellt|erstellt
months|Monate|Monaten|Monate|monatelang
deal|Angebot|Geschï¿½ft|handeln|handeln Sie
food|Lebensmittel|Essen|Nahrungsmittel|Nahrung
system|System|Das System|System
drew|drew|gezeichnet|zog
fit|fit|passen|fit
tom|Tom|Tom
afraid|Angst|ï¿½ngstlich|ï¿½ngstliche
property|Eigenschaft|Eigentum|Immobilie|Grundstï¿½ck
walked|zu Fuï¿½|ging|gegangen
von|von|von
mouth|Mund|Maul|Mund|Mund
page|Seite|Die Seite|Seite
seeing|siehe|sehen|Sehen Sie
east|Osten|Ost|east
stay|bleiben|Aufenthalt|Bleiben Sie
places|Orte|Plï¿½tze|Stellen|Orte
wrong|falsch|falsche
seven|sieben|7|sieben
rich|reich|reichen|reiche
ich|Ich|Ich
thirty|dreiï¿½ig|dreissig|dreiï¿½ig
british|britisch|britische|britisch
stone|Stein|Stein|Stein
single|einzeln|einfach|Einzelne|Einzel
tax|Steuer|Steuern|Steuer
language|Sprache|Sprache|Sprache|Die Sprache
dinner|Abendessen|Essen|Mittagessen|Dinner
appear|erscheinen|erscheint|siehe
tu|tu|du|tu
besides|neben|auï¿½er|Auï¿½erdem
knows|kennt|weiï¿½|weiï¿½|kennt
caught|gefangen|erwischt|ertappt
easily|einfach|leicht
condition|Zustand|Bedingung|Voraussetzung|Bedingungen
filled|gefï¿½llt|befï¿½llt|gefï¿½llte
secret|geheim|Geheimnis|heimlich|geheimes
wood|Holz|Holz|Holz
mary|mary|Maria
danger|Gefahr|Die Gefahr|Gefahren
middle|Mitte|mittel|Mitte
influence|Einfluss|beeinflussen|Einfluss nehmen|Einflussnahme
por|por|por|
march|Mï¿½rz|Marsch|Mï¿½rz
horses|Pferde|Pferden|Pferde
presence|Prï¿½senz|Anwesenheit|Gegenwart|Prï¿½senz
hall|Halle|Saal|Die Halle|Halle
getting|unter|zu bekommen|
week|Woche|Woche|Woche
thoughts|Gedanken|Ideen|Die Gedanken|Gedanken
simple|einfach|einfache|einfaches
loved|liebte|geliebt|liebt|hat geliebt
wall|Wand|Mauer|Die Wand
uncle|Onkel|Onkel
top|top|oben|Spitze
car|Auto|Fahrzeug|Wagen|Auto
date|Datum|Termin|Datum|Datum
girls|Mï¿½dchen|Frauen|Mï¿½dchen
parts|Teile|Ersatzteile|Teile|Bauteile
camp|Lager|Camp|Das Lager
unto|an|zu|auf|an
hath|hat|hat|hat
william|william|Wilhelm
limited|begrenzt|eingeschrï¿½nkt|beschrï¿½nkt|begrenzte
afterwards|danach|anschlieï¿½end|nachher
board|Vorstand|Brett|Brettchen
remain|bleiben|bleibt|Bleiben Sie
struck|angeschlagen|gestrichen|gestoï¿½en|geschlagen
wonder|Wunder|frage|Wunder
wait|warten|Warten Sie|warten
started|gestartet|begonnen|gestartet
distribution|Vertrieb|Verteilung|Verbreitung|Distribution
chair|Stuhl|Lehrstuhl|Vorsitz
appearance|Aussehen|Auftritt|Erscheinungsbild|Auftreten
cost|Kosten|Kosten|Kosten
wrote|schrieb|schreibt|schrieb|schrieb
regard|siehe|zu|siehe
bright|hell|helles|leuchtend
joy|Freude|Freude|Vergnï¿½gen|Freude
giving|Geben|Schenken
period|Zeitraum|Zeitraum|Periode|Zeitraum
eight|acht|acht|8
considerable|beachtlich|beachtliche|beachtliches|beachtlich
distributing|Verteilen|Verteilen von|Vertrieb|Verteilung
fight|Kampf|kï¿½mpfen|bekï¿½mpfen|Bekï¿½mpfung
write|schreiben.|Schreiben Sie
arrived|angekommen|eingetroffen|ankommen|angekommen
walk|Spaziergang|gehen|zu Fuï¿½
former|ehemals|frï¿½her|ehemalige|ehemalig
anyone|jeder|jemand|Jeder der
charles|charles|charls|Karl
moi|moi|Ich
moved|umgezogen|bewegt|verschoben|umziehen
evil|bï¿½se|Bï¿½ses
occasion|Anlass|Gelegenheit|Anlass
laughed|lachte|lacht|lï¿½chelte|lachte
hill|Hï¿½gel|Berg|Anhï¿½he
quiet|leise|ruhig|still|ruhige
stopped|gestoppt|aufgehï¿½rt|angehalten|gestoppt
respect|Respekt|respektieren|Achtung|achten
aux|aux|aux
command|Befehl|Der Befehl|Kommando|Befehl
president|Prï¿½sident|Der Prï¿½sident|Prï¿½sidentin
effort|Aufwand|Anstrengung|Mï¿½he|Bemï¿½hung
tears|Trï¿½nen|Trï¿½nen
quickly|schnell|rasch
raised|erhï¿½ht|angehoben|auf
village|Dorf|Das Dorf|Ortschaft
generally|allgemein|im Allgemeinen
christ|christ|christus|christ
scene|Szene|Szene|Szene
fresh|frisch|frisches|frischer
direction|Richtung|Richtung|Richtung|in Richtung
justice|Justiz|Gerechtigkeit|Recht|Justiz
una|una|una|a|de
learned|gelernt|erlernt|gelernt
owner|Eigentï¿½mer|Besitzer|Inhaber|Betreiber
deux|zwei
covered|ï¿½berdacht|abgedeckt|bedeckt|ï¿½berdachte
married|verheiratet|geheiratet|verheiratet
result|Ergebnis|Ergebnis|Das Ergebnis|Resultat
sin|Sï¿½nde|sï¿½ndigen|sin|sinken
experience|erleben|Erfahrung|Erlebnis|Erleben Sie
merely|lediglich|nur|einfach|bloï¿½
leaving|verlassen.|Verlassen von
music|Musik|Musik|Die Musik
youth|Jugend|Jugendliche|Jugendarbeit
efforts|Bemï¿½hungen|Anstrengungen|Maï¿½nahmen|Die Bemï¿½hungen
mission|Mission|Mission|Mission|Mission
lines|Zeilen|Linien|Leitungen|Zeilen
expression|Ausdruck|Ausdruck|Ausdrucksweise
due|fï¿½llig|wegen|due
grew|wuchs|gewachsen|wï¿½chst|wuchs
medium|mittel|Medium
noble|edel|edle|nobel|edel
garden|Garten|Garten|Garten
waiting|Warten|Wartezeit|Wartezeiten
worth|wert|im Wert von
colonel|Oberst|Oberst
showed|zeigte|zeigt|gezeigt|siehe
beside|neben|neben|unter
distribute|vertreiben|Verteilen|Verteilen Sie
volunteers|Freiwillige|Freiwilligenarbeit|Ehrenamtliche|Volontï¿½re
usual|ï¿½blich|ï¿½blich|ï¿½blich
discovered|entdeckt|entdeckt|entdeckte
brown|braun|braun|braune
national|national|Nationale
hot|heiï¿½|heiï¿½
henry|henry|Heinrich
lo|lo|lo|siehe
german|deutsch|german
expected|erwartet|erwartete
hat|Hut|hat|Hut
spring|Feder|Frï¿½hjahr|Frï¿½hling|Frï¿½hjahr
houses|Hï¿½user|Hï¿½user|Hï¿½user
christian|christlich|christian|christliche|christus
tone|Ton|Ton|
success|Erfolg|erfolgreich|Erfolg
race|Rennen|Rasse|Wettrennen
grace|Gnade|Anmut|Grace
piece|Stï¿½ck|Teil|Artikel|Stï¿½ck
somewhat|etwas|einigermaï¿½en|ein wenig
religion|Religion|Religion
iii|iii|iii
sitting|sitzend|Sitzen|sitzend
lives|lebt|Leben|Das Leben
nicht|not|non
using|mit|unter|ï¿½ber|unter
officers|Offiziere|Beamte|Beamten
entirely|vollstï¿½ndig|komplett|ganz|vï¿½llig
learn|lernen|Lernen Sie|erfahren Sie
news|Nachrichten|Neuigkeiten|News|Nachricht
fait|fait|fait|fair
monsieur|Herr|mr|Monsieur
military|Militï¿½r|militï¿½risch|Das Militï¿½r|militï¿½rische
rate|Satz|Satz|
fast|schnell|schnelle|schnell
reading|Lesen|Lesung|Lesen von
cross|Kreuz|ï¿½ber|Kreuz
scarcely|kaum|knapp|kaum
mit|mit|unter|mit
watch|Uhr|siehe|beobachten
royal|kï¿½niglich|royal
holy|Heilige|heilig|Heiliger
perfect|perfekt|perfektes|Perfekte
ancient|alt|alt|alt|alt
summer|Sommer|Sommer|im Sommer|Sommer
circumstances|Umstï¿½nde|Umstï¿½nde
faire|faire|fair|Messe|faire
political|politisch|politische|politischer
contact|Kontakt|Kontakt|Kontaktaufnahme
web|Web|Website|Internet|Web
meant|bedeutete|meinte|bedeutet|gemeint ist
afternoon|Nachmittag|Mittagessen|Nachmittags
sich|sich|sich
bit|bit|bit
silent|still|lautlos|leise|stumm
opportunity|Gelegenheit|Mï¿½glichkeit|Chance|Die Gelegenheit
step|Schritt|Stufe|Seite|Schritt
sit|sitzen|Sitz|sitze
observed|beobachtet|beobachtet|beobachtet
century|Jahrhundert|Jahrhunderts|Jahrhundert
goes|geht|unter|wird|geht
mere|nur|lediglich|bloï¿½|lediglich
speaking|Sprechen|sprechend
comply|entsprechen|erfï¿½llen|einhalten|einwilligen
winter|Winter|Der Winter|im Winter
possession|Besitz|Eigentum|Besitz
special|Spezial|Besonderes|Sonderseite|Sonderausgabe
author|Autor|Verfasser|Autorin|Schriftsteller
duke|Herzog|
class|Klasse|Die Klasse|Klasse
shot|Schuss|Aufnahme|Foto|Schuss
considered|als|betrachtet|als
sudden|Plï¿½tzlich|Plï¿½tzliche|Plï¿½tzlich|Plï¿½tzlicher
reach|erreichen.|erreichen Sie
keeping|unter|halten
formed|gebildet|gegrï¿½ndet|geformt
jack|jack|Buchse|Klinke
dog|Hund|Hund
conversation|Gesprï¿½ch|Unterhaltung|Konversation|Konversation
ways|Wege|Mï¿½glichkeiten|Methoden|Arten
fifty|fï¿½nfzig|50|fï¿½nfzig
distributed|verteilt|verteilte
original|Original|Original|ursprï¿½nglich
floor|Boden|Fuï¿½boden|Stockwerk|Boden
collection|Sammlung|Kollektion|Die Sammlung|Die Kollektion
su|su|su|
indian|indisch|indische
private|privat|persï¿½nlich|private
finally|schlieï¿½lich|endlich
cry|weinen|schreien
fortune|Glï¿½ck|Vermï¿½gen|Schicksal|Glï¿½ck
dem|dem|der
broke|kaputt|pleite|gebrochen
freely|frei|kostenlos|frei
shore|Landseite|Ufer|Kï¿½ste|Land
picture|Bild|Abbildung|Foto|Bild
lake|See|Der See|See
greatest|grï¿½ï¿½te|grï¿½ï¿½ten|Die grï¿½ï¿½te
allowed|erlaubt|zugelassen|zulï¿½ssig
plan|Plan|planen|Plan
judge|Richter|Richterin|Richter
america|amerika|amerika|USA
value|Wert|Der Wert|Wert
stop|stoppen|Stopp|aufhï¿½ren
soldiers|Soldaten|Soldatinnen und Soldaten
eat|essen|Essen Sie
las|las|las
lot|Los|Grundstï¿½ck|Partie|Posten
proper|richtig|richtiges|
study|Studie|studieren|Studium|lernen
meeting|Treffen|Sitzung|Tagung|Besprechung
glass|Glas|Glas|Glass
marriage|Ehe|Heirat|Hochzeit|Heiraten
terrible|schrecklich|furchtbar|schreckliche
trying|Versuch|versuchen
nation|Nation|Land|Staat
vain|eitel|eitle|vergeblich|eitler
enter|eingeben.|eintragen
fort|Fort|Festung|Fort
official|offiziell|offizielle
leaves|Blï¿½tter|Blï¿½tter|lï¿½sst|verlï¿½sst
killed|getï¿½tet|umgebracht|getï¿½tete|getï¿½tet
bank|Bank|Die Bank
reply|Antwort|Antwort|antworten
obtain|erhalten|erhalten Sie|beziehen
flowers|Blumen|Blï¿½ten|Blumen
speech|Rede|Sprache|Ansprache|Vortrag
posted|gepostet|verï¿½ffentlicht|gebucht
declared|erklï¿½rt|erklï¿½rte|angemeldet|erklï¿½rt
turning|Drehen|Wenden
james|james|jones
takes|nimmt|unter|nimmt
grave|Grab|Grabstï¿½tte|Grab
required|erforderlich|benï¿½tigt|erforderliche
difficult|schwierig|schwierig
escape|Flucht|entkommen
straight|gerade|direkt|gerade
marked|markiert|gekennzeichnet|gekennzeichnet mit
wished|wï¿½nschte|wï¿½nschte sich|gewï¿½nscht|wollte
minute|Minute|Protokoll|Minute
situation|Lage|Situation|Die Lage|Lagebericht
troops|Truppen|Truppe|Trupps
soft|weich|weiches|weich
drawn|gezeichnet|gezogen|gezeichnet
lie|liegen|lie|Lï¿½ge|lï¿½gen
passage|Durchgang|Passage|Durchfahrt|ï¿½bergang
saint|heilige|heilig|Heiliger
pain|Schmerzen|Schmerz|Schmerzen
corner|Ecke|Die Ecke|Ecke
journey|Reise|Anreise|Anfahrt|Fahrt
om|om|om
morrow|morrow|morgen
likely|wahrscheinlich|voraussichtlich|vermutlich
attempt|Versuch|versuchen|Versuch|Versuch
beneath|unter|unterhalb von|unter
additional|zusï¿½tzlich|zusï¿½tzliche|weitere
built|gebaut|erbaut
cases|Fï¿½lle|Gehï¿½use|Koffer|Fï¿½llen
modern|modern|modernes|moderne
surprise|ï¿½berraschung|ï¿½berraschung|ï¿½berraschung|ï¿½berraschung
orders|Bestellungen|Auftrï¿½ge|Bestellung|bestellt
trade|Handel|handeln
honour|Ehre|ehren|honorieren
personal|persï¿½nlich|Persï¿½nliches
authority|Behï¿½rde|Autoritï¿½t|Die Behï¿½rde
phrase|Phrase|Satz|Ausdruck|Phrase
cast|gieï¿½en|gegossen|Guss
changed|geï¿½ndert|verï¿½ndert|gewechselt
aunt|Tante|Tante
trust|Vertrauen
walls|Wï¿½nde|Mauern|Die Wï¿½nde|Wï¿½nden
dress|Kleid|Kleidung|kleiden
lower|unter|unten|unter
spot|Punkt|Spot|Stelle|Punkt
sky|Himmel|sky|Himmel
members|Mitglieder|Die Mitglieder|Mitgliedern
determined|bestimmt|ermittelt|festgelegt|entschlossen
removed|entfernt|beseitigt
pleasant|angenehm|angenehmes|angenehme
running|lï¿½uft|Laufen
instant|sofort|sofortige
officer|Offizier|Officer|Offizier
passing|vorbei an|ï¿½ber|vorbei
prepared|vorbereitet|zubereitet|erstellt|vorbereitet
concerning|betreffend|zu|ï¿½ber|bezï¿½glich
iron|Eisen|Eisen
simply|einfach|ganz einfach|einfach
train|Zug|Zug|Zug
mountain|Berg|Gebirge|Berge
accepted|akzeptiert|angenommen|anerkannt|akzeptiert
physical|physisch|physikalisch|kï¿½rperlich
offered|angeboten|bot
rome|Rom|rome|Rom
dan|dan|dan
appears|erscheint|erscheint|erscheint
closed|geschlossen|abgeschlossen
silver|Silber|silbern|silberne
forget|vergessen|vergessen Sie|vergiss
named|namens|mit dem Namen|unter dem Namen|namens
believed|glaubte|geglaubt|glaubten
talking|sprechend|sprechende|redend
wise|weise|klug|kluge|weise
social|sozial|Soziales|gesellschaftlich
allow|ermï¿½glichen|erlauben|Erlauben Sie
mark|mark|Marke|Markierung
ladies|Damen|Frauen|Damen
snow|Schnee|Schnee|Schnee|Schnee
och|och|und|och|oder
europe|eu
bill|b
safe|sa
begin|beginnen|Beginn|Anfang
lead|Blei|fï¿½hren|Fï¿½hrung|Blei
break|Pause|brechen|unterbrechen
supposed|angeblich|vermeintlich|vermeintliche
memory|Speicher|Speicher|Gedï¿½chtnis
pleased|zufrieden|erfreut|freut sich|froh
steps|Schritte|Stufen|Maï¿½nahmen|steps
spread|Verbreitung|Streuung|verbreiten
warm|warm|herzlich|warmes
laugh|lachen|lacht|lachend
matters|Angelegenheiten|Fragen|Themen|Dinge
fish|Fisch|Fische|Fisch
religious|religiï¿½s|religiï¿½se|Religion|religiï¿½ser
surely|sicher|sicherlich|bestimmt
etc|usw.|etc|usw
existence|Existenz|Dasein|Bestehen|Leben
compliance|Compliance|Einhaltung der Vorschriften|Einhaltung der Bestimmungen|Einhaltung von Vorschriften
ourselves|uns selbst|selbst|wir selbst|uns
attack|angreifen|Angriff|anzugreifen
perfectly|perfekt|vollkommen|perfekt
happiness|Glï¿½ck|Freude|Glï¿½ck
breath|Atem|Hauch|Atem|Atmen
gives|gibt|bietet|unter|gibt
rock|Felsen|rocken|Fels
looks|siehe|schaut|sieht aus|sieht
rise|aufsteigen|steigen|Anstieg|aufstehen
presently|Zurzeit|zur Zeit|Derzeit
questions|Fragen|Fragen|Anfragen
month|Monat|monatlich|Monat
foreign|Ausland|auslï¿½ndische|im Ausland|auslï¿½ndisch
quick|schnell|schnelle|schnelles
courage|Mut|Mut|Mut|Mutig
replacement|Ersatz|Austausch|Ersatz|Ersatz fï¿½r
encore|Zugabe|Zugabe|Zugabe|Die Zugabe
game|Spiel|Das Spiel|zum Spiel
complete|vollstï¿½ndig|vollstï¿½ndige|komplett
roman|romanisch|rï¿½misch|romanische|roman
difficulty|Schwierigkeit|Schwierigkeiten|Schwierigkeitsgrad|Problem
search|Suche|suchen|Suche
understood|verstanden|verstehen
touch|berï¿½hren.|berï¿½hren Sie
mountains|Berge|Gebirge|Bergen
ships|Schiffe|Schiff|Schiffe
post|Beitrag|post
move|umziehen|bewegen
union|Gewerkschaft|Vereinigung|Gewerkschaft
thank|danke|danken
higher|hï¿½her|hï¿½here|mehr
pale|blass|bleich|blasse|hell
rule|Regel|Regelung|Regel|Die Regel
forty|vierzig|vierzig|40
share|Aktie|teilen|Anteil|teilen
forest|Wald|Forst|Wald|Wald
affairs|Angelegenheiten|Geschï¿½fte|Affï¿½ren|Angelegenheiten
wonderful|wunderbar|wunderbar|wunderbar
moral|moralisch|Moral|moralische
lying|liegend|liegen|Lï¿½gen|liegende
promise|Versprechen|Zusage|Verheiï¿½ung
loss|Verlust|Schaden|Verluste|Verlust
sorry|Entschuldigung|sorry|Tut mir leid
maar|maar|maar
para|para|Absatz|para
fixed|fest|fixiert|fix|festgesetzt
sufficient|ausreichend|genï¿½gend|ausreichende
box|Box|Kasten
darkness|Dunkelheit|Finsternis|Die Dunkelheit
worse|schlechter|schlimmer
names|Namen|Die Namen|Name
directly|direkt|unmittelbar|direkt
building|Gebï¿½ude|Das Gebï¿½ude|Bauen|Gebï¿½ude
indians|Indianer|Inder|Indios
gentlemen|Herren|Meine Herren|Herrschaften
equal|gleich|gleiche|gleichberechtigt|gleich
ist|ist|ist|is
twelve|zwï¿½lf|12|zwï¿½lf
spent|ausgegeben|verbraucht|verbracht|ausgeben
example|Beispiel|Beispiel|Beispiel
working|arbeiten|Arbeitet|Arbeit
space|Raum|Weltraum|Platz|Raumfahrt
iv|iv|iv
agreed|vereinbart|einverstanden|vereinbarte|zugestimmt
conduct|durchfï¿½hren|fï¿½hren|Verhalten
seat|Sitz|Sitzplatz|Platz|Sitzflï¿½che
ordered|bestellt|bestellte|Bestellung
passion|Leidenschaft|Passion|Leidenschaft
active|aktiv|aktiv
population|Bevï¿½lkerung|Die Bevï¿½lkerung|Einwohnerzahl|Bevï¿½lkerung
count|zï¿½hlen|Zï¿½hlung
health|Gesundheit|Gesundheit|Gesundheitszustand
online|online|Internet|Internet
movement|Bewegung|Die Bewegung|Uhrwerk
usually|in der Regel|normalerweise|gewï¿½hnlich
sake|Sake|Sake
proved|bewiesen|nachgewiesen|geprï¿½ft|bewï¿½hrt
governor|Gouverneur|Statthalter|Gouverneurin|Gouverneur
drink|trinken|Getrï¿½nk|Trinken Sie
dry|trocken|trocken
ones|Die|der
peter|peter|petrus
possessed|besessen|Besessenheit|besucht
particularly|insbesondere|besonders|vor allem
prevent|verhindern.|zu verhindern
coast|Kï¿½ste|Die Kï¿½ste|Kï¿½ste
smiled|lï¿½chelte|lï¿½chelt|lï¿½chelte|lachte
serious|seriï¿½s|seriï¿½se|ernsthafte|ernsthaft
heads|Kï¿½pfe|Kopf|Kï¿½pfe
degree|Grad|Abschluss|Diplom|Grades
described|beschrieben|beschrieben
ears|Ohren|Ohren|Ohren
song|Lied|Song|Song|Lied
shown|siehe|angezeigt|gezeigt
dream|Traum|Traum|trï¿½umen
threw|warf|geworfen|hat geworfen
ha|ha|ha
spoken|gesprochen|gesprochen|gesprochene
servant|Diener|Bediensteter|Dienerin|Knecht
fallen|gefallen|fallen|gefallen
conditions|Bedingungen|Konditionen|Voraussetzungen|Bestimmungen
report|Bericht|berichten|melden
liberty|Freiheit|Freiheit
clothes|Kleidung|Kleider|Bekleidung|Kleidungsstï¿½cke
forms|Formulare|Formen|bildet|Formulare
group|Gruppe|Die Gruppe|Gruppe
drawing|Zeichnung|Zeichnen|Die Zeichnung
exactly|genau|genau|exakt
jesus|jesus|jesus|jesu
dont|nicht|nicht
native|einheimische|einheimisch|gebï¿½rtig
powers|Krï¿½fte|Befugnisse|Leistungen|Kompetenzen
valley|Tal|valley
guard|Wache|Wï¿½chter|Schutz|Wachmann
broad|breit|Breit gefï¿½chert|breit
repeated|wiederholt|Wiederholung|Wiederholte
mentioned|erwï¿½hnt|genannt|erwï¿½hnte
pure|rein|pur|Reines
divine|gï¿½ttlich|gï¿½ttliche|gï¿½ttlichen|gï¿½ttliches
immediate|sofort|unverzï¿½glich|sofortige
site|Website|Standort|Seite|Website
engaged|engagiert|beschï¿½ftigt|besetzt|verlobt
crowd|Menge|Publikum|Menschenmenge|Die Menge
decided|beschlossen|entschieden|beschlossen|beschloss
path|Pfad|Weg|Pfad
extent|Umfang|Ausmaï¿½|Umfang|Umfang
method|Methode|Verfahren|Die Methode
glory|Ruhm|Herrlichkeit|Ruhm und Ehre
paul|paul|paul|pUL
shook|schï¿½ttelte|geschï¿½ttelt|schï¿½ttelten|rï¿½ttelte
wine|Wein|Wein
era|ï¿½ra|Zeitalter|Epoche|ï¿½ra
spite|Trotz|Gehï¿½ssigkeit|Bosheit
total|insgesamt|gesamt
fate|Schicksal|Das Schicksal|Schicksal
weeks|weeks
intended|intended|intentional
caused|verursacht|verursachte|verursacht|erstellt
golden|goldene|golden|goldenen
professor|Professor|Prof|Professorin
throughout|auf|unter|in ganz|im gesamten
direct|direkt|direkt|unmittelbar
progress|Fortschritte|Fortschritt|Verlauf|Fortschritte
produce|produzieren|erzeugen|herstellen
damages|Schï¿½den|Schadenersatz|Schadensersatz|Schï¿½den
science|Wissenschaft|Wissenschaft|Wissenschaften
major|Haupt|Hauptartikel|Haupt|Hauptteil
interesting|interessant|Interessante
consider|berücksichtigen.|siehe|prüfen
sick|krank|krank
serve|dienen|servieren
sword|Schwert|Das Schwert|Schwerter
minister|Minister|Ministerin|Pfarrer
opposite|gegenüber|gegenüber|Gegenüber von
finished|fertig|fertiggestellt|beendet|abgeschlossen
pride|Stolz|Stolz
animal|Tier|Tiere|Tier|tierisch
louis|louis|louise
auf|auf|unter|auf
hills|hügel|hills|Berge
anxious|ängstlich|besorgt
expect|erwarten|erwartet
ordinary|normal|normaler|normales|normal
nine|neun|neun|9
meaning|Bedeutung|Bedeutung|bedeutet|Die Bedeutung
importance|i
emperor|Kaiser|Der Kaiser|Kaiser
capital|Kapital|Hauptstadt|Das Kapital
mighty|mächtig|mächtige|gewaltig
permitted|zugelassen|erlaubt|zulässig|zulässige
birds|Vögel|Vögel
watched|beobachtet|beobachtete|gesehen
principal|Auftraggeber|Hauptartikel|Hauptsache|Hauptsächlich
re|zu|über|zu
located|Standort|unter|befindet sich
instance|Instanz|Beispiel|Beispiel|Instanz
narrow|schmal|eng
offer|o
included|inklusive|enthalten|einschließlich
sides|Seiten|Die Seiten|Seite|Seiten
editions|Ausgaben|Editionen|Die Ausgaben|Auflagen
bread|Brot|Brot
curious|neugierig|Neugierige
greatly|sehr|stark|sehr
fancy|schick|schickes|schicke|ausgefallen
stream|Strom|Stream|Strom
requirements|Anforderungen|Voraussetzungen|Bedürfnisse|Anforderungen
neck|Nacken|Hals|Nacken
confidence|Vertrauen|Zuversicht|Selbstvertrauen|Selbstbewusstsein
sharp|scharf|Scharfes
evidence|Beweise|Beweismittel|Nachweis|Nachweise
education|Bildung|Ausbildung|Erziehung
glance|Blick|siehe|Blick
excellent|ausgezeichnet|hervorragend|ausgezeichnete
honor|ehren|Ehre|honorieren
clearly|eindeutig|eindeutig|eindeutig
holding|Betrieb|halten
don|don|thon
sign|Zeichen|unter|unterzeichnen|unterschreiben
similar|ähnlich|ähnliche|ähnliches
difference|Unterschied|Differenz|Abweichung|Unterschiede
vol|Band|vol|Bd
gate|Tor|Tor|Gate
ideas|Ideen|Anregungen|Vorstellungen
surface|Oberfläche|Fläche|Die Oberfläche|Oberfläche
islands|Inseln|Die Inseln|Inseln
pieces|Stücke|Stück|Teile|Stückzahl
aside|beiseite|zur Seite|Seite|beiseite
created|erstellt|erstellte
vast|.
rising|steigend|aufsteigend|steigende
sentence|Satz|Urteil|Satz|Der Satz
station|Bahnhof|Bahnhof|Bahnhof|Bahnhof
providing|Bereitstellung von|die Bereitstellung von|Bereitstellung|die Bereitstellung
obliged|verpflichtet|obligatorisch|verpflichtet
legal|legal|rechtlich|rechtsgültig|Rechtliches
yellow|gelb|gelbe
square|Platz|quadratisch|Quadrat
forced|gezwungen|erzwungen|erzwungene
dropped|fallen gelassen|fallengelassen|gefallen|entfällt
fees|Gebühren|Kosten|Preise|Honorare
otherwise|ansonsten|sonst|andernfalls
brave|tapfer|mutig
carefully|sorgfältig|vorsichtig|aufmerksam
knowing|wissen|kennen
hem|Saum|Saum|Säume|säumen
dollars|Dollar|Dollars|US-Dollar|$
advantage|Vorteil|Vorteil|Vorsprung
numerous|zahlreiche|zahlreich|zahlreichen
status|Status|Zustand|Stand
altogether|insgesamt|ganz|insgesamt
forgotten|vergessen|vergessene
prove|beweisen|belegen|beweisen
points|Punkte|Weichen|Punkten|Punkte
accept|akzeptieren|annehmen|akzeptieren Sie
robert|robert|rotter
weather|Wetter|Das Wetter|Wetter
promised|versprochen|zugesagt
title|Titel|Titel|Überschrift
aid|Hilfe|Beihilfe|Unterstützung
address|Adresse|Adresse|Anschrift|Adresse
bottom|unten|Boden|Unterseite
stage|Bühne|Bühne|Stufe|Etappe
claim|cl|cl|kl
woods|Wälder|Wald|Holz|Hölzer
washington|washington|Washington
explanation|Erklärung|Erläuterung|Erläuterungen|Begründung
donate|spenden|spenden Sie
thomas|thomas|THOMAS
price|Preis|Preis|Preise
animals|Tiere|Tieren|Tiere
grass|Gras|Rasen|Gras
tea|Tee|Tee|Tee
um|um|ähm|um
fully|f
yours|f
pray|f
worthy|f
settled|f
thick|dick|dickes|dick|dick
